THE TREASURE IS BURIED BETWEEN THE FOUR TREES

WWWWWWWWWWWWWWWWWWWWWWW,,,,,,^^^^,,,WWWWWWWW
WWWWWWWWWWWWWWWWWWWWWW,,,,,,^^^^,,,,WWWWWWWW
WWWWWWWWWWWWWWWWWWWWWW,,,,,,^^^,,,,,,WWWWWWW
WWWWWWWWWWWWWWWWWWWWW,,T,,,,,^^^^,,T,WWWWWWW
WWWWWWWWWWWWWWWWWWWWW,,,,,,,,^^^^,,T,WWWWWWW
WWWWWWWWWWWWWWWWWWWW,,,,,,,,^^^,,,,T,WWWWWWW
WWWWWWWWWWWWWWWWWWWW,,,,,,,,^^^,,,,,,WWWWWWW
WWWWWWWWWWWWWWWWWWWWWW,,,,,^^^^,,,,,WWWWWWWW
WWWWWWWWWWWWWWWWWWWWWW,,,,,^^^,,,,,,WWWWWWWW
WWWWWWWWWWWWWWWWWWWWWWW,,,,^^,,,,,,WWWWWWWWW
WWWWWWWWWWWWWWWWWWWWWW,,,,,,^,,,,,WWWWWWWWWW
WWWWWWWWWWWWWWWWWWWWW,,,,,,,,,,,,WWWWWWWWWWW
WWWWWWWWWWWWWWWWWWWW,,,T,T,,,,,WWWWWWWWWWWWW
WWWWW,,,WWWWWWWWWWWWW,,,,,,,,,,WWWWWWWWWWWWW
WWWW,,T,,,WWWWWWWWWWW,,T,T,,,,WWWWWWWWWWWWWW
WWWWW,,,,,,,WWWWWWWWWWW,,,,,,WWWWWWWWWWWWWWW
WWWWWWWW,,,T,WWWWWWWWWWWWWWWWWWWWWWWWWWWWWWW
WWWWWWWWW,,,,WWWWWWWWWWWWWWWWWWWWWWWWWWWWWWW
WWWWWWWWWW,T,WWWWWWWWWWWWWWWWWWWWWWWWWWWWWWW
WWWWWWWWWWW,WWWWWWWWWW,,,,,WWWWWWWWWWWWWWWWW
WWWWWWWWWWWWWWWWWWWWW,,,,,,,WWWWWWWWWWWWWWWW
WWWWWWWWWWWWWWWWWWWWWWW,,TT,,WWWWWWWWWWWWWWW
WWWWWWWWWWWWWWWWWWWWWWW,,,,,WWWWWWWWWWWWWWWW
WWWWWWWWWWWWWWWWWWWWWW,,,WWWWWWWWWWWWWWWWWWW
WWWWWWWWWWWWWWWWWWWWWWWWWWWWWWWWWWWWWWWWWWWW
WWWWWWWWWWWWWWWWWWWWWWWWWWWWWWWWWWWWWWWWWWWW
WWWWWWWWWWWWWWWWWWWWWWWWWWWWWWWWWWWWWWWWWWWW

W: WATER
T: TREE
,: GRASS
^: MOUNTAIN