XIL7XOL2MYOL7HM73YOHLZ73LXULLD7XIL7KEYO7XOLLM

UUU888U4UU444U8484U8UU8R55R5RSSSS55RUUUUU8U4
4UU48U8888UUUUUUU44UU855R555SSSS5RRR84U4U8U8
U4U84UUUU44UU844444UUU55555RSSSRRRR558U4UUUU
44UUUUU4U4U484U4UU88855XR5RRRSSSSR5X5UU4UU8U
48U4U884U888U88888UUURRRRRR5RSSSSRRXR8UUU4U8
UUUU88U8UU8U8U4U8U84R55555RRSSSRRRRXRU8U888U
8U88484UUU8U8U8848UU55R55555SSSR5RR5R48U48UU
UU8UUUU88UU8U44U44U84U5555RSSSS55555UUUU4UUU
8U4484U4U8UUUU84884UU85RR5RSSSR555558UU8U8U8
8U4UUUU8UUU8U44UU4UUUU45RR5SS5RRR55UUUU8444U
U48UUUU8U48U84848UU488555R5RSRRRRRU888U484U4
U88UU8UUU8U4488UUUUU45RR5555R5555UUUUU48UUUU
8UUU884UU8U8U8UUU4UU5RRX5XRR5R54U44888UU4U8U
UUU88RRR8U48888UU48U4RR5R5RR555UU4UUUU8UUUU4
UU445RXRRR44U4444UUUURRXRX555RU4U44U44U8UU8U
UUUU4RR5RRRRUU4UU8444U45RRRRR88U4UUUUU488444
84444UU45R5X5U444U488U8U88888484UUUUUUUU8UUU
8U8UU8U4U5RR5UU4U4UUU484444U4UU8UU888U84U84U
8844U8U4U8RXR88U8UU8UU48U88448UU8UUU88U448U4
84U8U84U44UR88U48U8UUU555RR4UU8U8UUU888U4U48
UU4UUU8UUUU484UU88U88RRRR5RRU8U4488UU4UU44U8
U4U484U4UUUU4UUUU4U4U84R5XX5R488UU844UU4UUU8
U8U8UU8UU48U84U8UUU4U4UR55RR8UUU44444UUU8848
884U4U488U88448UUU88UURRRU844U4UU844UUU48U84
U8UU4U8U44UU484488U84UUU88UU8UUUUU4UU44U44UU
4UUUUUUU8UUU4UUUUUU88U8UUU4UUU48UU4UU88U4UUU
U44UU444U8884U4U84UU444U8UUUUUU84448UU888U84

UQ7U2XLO
XQ7XOLL
5Q7JO2MM
SQ7CEYDX2HD